size,19,9,
X,X,X,X,X,X,X,X,X,X,X,X,X,X,X,X,X,X,X,
X,2,0,X,X,2,0,X,O,O,O,O,O,O,O,O,O,3,X,
X,O,O,X,0,O,X,X,O,0,X,0,X,0,X,X,0,X,X,
X,0,O,0,O,O,O,O,O,O,O,O,O,O,O,O,O,0,X,
X,O,O,O,O,0,X,X,O,0,X,X,X,X,0,X,O,X,X,
X,O,0,1,0,X,2,X,O,X,X,2,0,2,X,X,O,2,X,
X,O,X,X,X,O,O,X,O,O,X,O,X,O,0,X,O,X,X,
X,O,O,O,2,O,0,X,0,O,O,O,O,O,2,X,O,2,X,
X,X,X,X,X,X,X,X,X,X,X,X,X,X,X,X,X,X,X,