size,8,10,
X,X,X,X,X,X,X,X,
X,0,X,X,1,X,3,X,
X,2,X,O,O,O,O,X,
X,O,X,O,0,O,0,X,
X,O,0,O,2,O,O,X,
X,O,O,O,0,X,O,X,
X,0,X,X,X,0,O,X,
X,2,O,0,O,O,O,X,
X,0,O,O,O,X,0,X,
X,X,X,X,X,X,X,X,